local-authority-discovery	local-authority	uk
WSX-UB	local-authority-eng:ADD	ENG
CMA-UB	local-authority-eng:ALB	ENG
DBY-UB	local-authority-eng:AMV	ENG
WSX-UC	local-authority-eng:ARD	ENG
KEN-UB	local-authority-eng:ASB	ENG
NTT-UB	local-authority-eng:ASD	ENG
BKM-UB	local-authority-eng:AYV	ENG
HAM-UB	local-authority-eng:BAA	ENG
ESS-UB	local-authority-eng:BAS	ENG
BBD	local-authority-eng:BBD	ENG
SFK-UB	local-authority-eng:BBG	ENG
BDF	local-authority-eng:BDF	ENG
BDG	local-authority-eng:BDG	ENG
BEN	local-authority-eng:BEN	ENG
BEX	local-authority-eng:BEX	ENG
CMA-UC	local-authority-eng:BIF	ENG
BIR	local-authority-eng:BIR	ENG
BKM	local-authority-eng:BKM	ENG
LEC-UB	local-authority-eng:BLD	ENG
NTT-UC	local-authority-eng:BLW	ENG
BMH	local-authority-eng:BMH	ENG
BAS	local-authority-eng:BNE	ENG
BRC	local-authority-eng:BNF	ENG
BNH	local-authority-eng:BNH	ENG
BNS	local-authority-eng:BNS	ENG
BNE	local-authority-eng:BNT	ENG
LIN-UB	local-authority-eng:BOB	ENG
NFK-UE	local-authority-eng:BOC	ENG
DBY-UC	local-authority-eng:BOD	ENG
BOL	local-authority-eng:BOL	ENG
BPL	local-authority-eng:BPL	ENG
BRD	local-authority-eng:BRD	ENG
NFK-UB	local-authority-eng:BRL	ENG
WOR-UB	local-authority-eng:BRM	ENG
NFK-UC	local-authority-eng:BRO	ENG
ESS-UC	local-authority-eng:BRT	ENG
BRY	local-authority-eng:BRY	ENG
BST	local-authority-eng:BST	ENG
ESS-UD	local-authority-eng:BTW	ENG
LAN-UD	local-authority-eng:BUB	ENG
BUR	local-authority-eng:BUR	ENG
HRT-UB	local-authority-eng:BXB	ENG
NTT-UD	local-authority-eng:BXT	ENG
CAM	local-authority-eng:CAM	ENG
ESS-UE	local-authority-eng:CAP	ENG
LEC-UC	local-authority-eng:CAW	ENG
CBF	local-authority-eng:CBF	ENG
NTH-UB	local-authority-eng:CBY	ENG
CAM-UB	local-authority-eng:CCC	ENG
STS-UB	local-authority-eng:CCH	ENG
CHE	local-authority-eng:CEA	ENG
ESS-UF	local-authority-eng:CHC	ENG
LIN-UD	local-authority-eng:CIO	ENG
CLD	local-authority-eng:CLD	ENG
LAN-UE	local-authority-eng:CLY	ENG
CMA	local-authority-eng:CMA	ENG
CMD	local-authority-eng:CMD	ENG
CMA-UE	local-authority-eng:COB	ENG
CON	local-authority-eng:CON	ENG
COV	local-authority-eng:COV	ENG
DOR-UC	local-authority-eng:CRC	ENG
NYK-UB	local-authority-eng:CRD	ENG
CMA-UD	local-authority-eng:CRL	ENG
OXF-UB	local-authority-eng:CWL	ENG
WSX-UE	local-authority-eng:CRW	ENG
CRY	local-authority-eng:CRY	ENG
DBY-UD	local-authority-eng:CSF	ENG
WSX-UD	local-authority-eng:CHS	ENG
ESS-UG	local-authority-eng:CST	ENG
KEN-UC	local-authority-eng:CTB	ENG
BKM-UC	local-authority-eng:CTN	ENG
GLS-UB	local-authority-eng:CHE	ENG
GLS-UC	local-authority-eng:CWD	ENG
CHW	local-authority-eng:CWE	ENG
HRT-UC	local-authority-eng:DAB	ENG
NTH-UC	local-authority-eng:DAD	ENG
DAL	local-authority-eng:DAL	ENG
DBY	local-authority-eng:DBY	ENG
DBY-UF	local-authority-eng:DED	ENG
DER	local-authority-eng:DER	ENG
DEV	local-authority-eng:DEV	ENG
KEN-UD	local-authority-eng:DFD	ENG
DNC	local-authority-eng:DNC	ENG
DOR	local-authority-eng:DOR	ENG
DUD	local-authority-eng:DUD	ENG
DUR	local-authority-eng:DUR	ENG
KEN-UE	local-authority-eng:DVR	ENG
CAM-UC	local-authority-eng:EAC	ENG
EAL	local-authority-eng:EAL	ENG
NTH-UD	local-authority-eng:EAN	ENG
STS-UC	local-authority-eng:EAS	ENG
ESX-UC	local-authority-eng:EBO	ENG
CMA-UF	local-authority-eng:EDD	ENG
DEV-UB	local-authority-eng:EDE	ENG
DOR-UD	local-authority-eng:EDO	ENG
HAM-UC	local-authority-eng:EHA	ENG
HRT-UD	local-authority-eng:EHE	ENG
SRY-UB	local-authority-eng:ELB	ENG
HAM-UD	local-authority-eng:ELG	ENG
LIN-UC	local-authority-eng:ELI	ENG
ENF	local-authority-eng:ENF	ENG
SRY-UC	local-authority-eng:EPA	ENG
ESS-UH	local-authority-eng:EPF	ENG
DBY-UG	local-authority-eng:ERB	ENG
ERY	local-authority-eng:ERY	ENG
ESS	local-authority-eng:ESS	ENG
ESX	local-authority-eng:ESX	ENG
DEV-UC	local-authority-eng:EXC	ENG
HAM-UE	local-authority-eng:FAB	ENG
CAM-UD	local-authority-eng:FLD	ENG
SFK-UC	local-authority-eng:FOH	ENG
GLS-UD	local-authority-eng:FOO	ENG
LAN-UF	local-authority-eng:FYB	ENG
GAT	local-authority-eng:GAT	ENG
NTT-UE	local-authority-eng:GEB	ENG
GLA	local-authority-eng:GLA	ENG
GLS-UE	local-authority-eng:GLC	ENG
GLS	local-authority-eng:GLS	ENG
HAM-UF	local-authority-eng:GOB	ENG
KEN-UG	local-authority-eng:GRB	ENG
GRE	local-authority-eng:GRE	ENG
NFK-UD	local-authority-eng:GRY	ENG
SRY-UD	local-authority-eng:GUB	ENG
ESS-UJ	local-authority-eng:HAC	ENG
HAL	local-authority-eng:HAL	ENG
HAM	local-authority-eng:HAM	ENG
HAV	local-authority-eng:HAV	ENG
LEC-UD	local-authority-eng:HBG	ENG
NYK-UC	local-authority-eng:HBT	ENG
HCK	local-authority-eng:HCK	ENG
HRT-UE	local-authority-eng:HEB	ENG
HEF	local-authority-eng:HEF	ENG
NYK-UD	local-authority-eng:HGT	ENG
LEC-UE	local-authority-eng:HIA	ENG
HIL	local-authority-eng:HIL	ENG
DBY-UH	local-authority-eng:HIP	ENG
HMF	local-authority-eng:HMF	ENG
HNS	local-authority-eng:HNS	ENG
WSX-UF	local-authority-eng:HOD	ENG
HPL	local-authority-eng:HPL	ENG
HAM-UG	local-authority-eng:HAR	ENG
HRT	local-authority-eng:HFS	ENG
HRW	local-authority-eng:HRW	ENG
HRY	local-authority-eng:HRY	ENG
ESX-UD	local-authority-eng:HST	ENG
CAM-UE	local-authority-eng:HUD	ENG
HAM-UH	local-authority-eng:HVT	ENG
LAN-UG	local-authority-eng:HYB	ENG
IOS	local-authority-eng:IOS	ENG
IOW	local-authority-eng:IOW	ENG
SFK-UD	local-authority-eng:IPB	ENG
ISL	local-authority-eng:ISL	ENG
NTH-UE	local-authority-eng:KEB	ENG
KEC	local-authority-eng:KEC	ENG
KEN	local-authority-eng:KEN	ENG
KHL	local-authority-eng:KHL	ENG
KIR	local-authority-eng:KIR	ENG
KTT	local-authority-eng:KTT	ENG
KWL	local-authority-eng:KWL	ENG
LAN-UH	local-authority-eng:LAC	ENG
LAN	local-authority-eng:LAN	ENG
LBH	local-authority-eng:LBH	ENG
LCE	local-authority-eng:LCE	ENG
LDS	local-authority-eng:LDS	ENG
LEC	local-authority-eng:LEC	ENG
ESX-UF	local-authority-eng:LED	ENG
LEW	local-authority-eng:LEW	ENG
STS-UD	local-authority-eng:LID	ENG
LIN	local-authority-eng:LIN	ENG
LIV	local-authority-eng:LIV	ENG
LND	local-authority-eng:LND	ENG
LUT	local-authority-eng:LUT	ENG
KEN-UH	local-authority-eng:MAB	ENG
WOR-UC	local-authority-eng:MAH	ENG
MAN	local-authority-eng:MAN	ENG
MDB	local-authority-eng:MDB	ENG
ESS-UK	local-authority-eng:MDN	ENG
MDW	local-authority-eng:MDW	ENG
LEC-UG	local-authority-eng:MEB	ENG
SOM-UB	local-authority-eng:MED	ENG
DEV-UD	local-authority-eng:MID	ENG
MIK	local-authority-eng:MIK	ENG
SRY-UE	local-authority-eng:MOV	ENG
MRT	local-authority-eng:MRT	ENG
NTT-UF	local-authority-eng:MSF	ENG
SFK-UE	local-authority-eng:MSK	ENG
WSX-UG	local-authority-eng:MSX	ENG
NBL	local-authority-eng:NBL	ENG
DEV-UE	local-authority-eng:NDE	ENG
DOR-UE	local-authority-eng:NDO	ENG
STS-UE	local-authority-eng:NED	ENG
HAM-UJ	local-authority-eng:NEF	ENG
NEL	local-authority-eng:NEL	ENG
NET	local-authority-eng:NET	ENG
NFK	local-authority-eng:NFK	ENG
NGM	local-authority-eng:NGM	ENG
NLN	local-authority-eng:NLN	ENG
NTH-UF	local-authority-eng:NOB	ENG
NFK-UG	local-authority-eng:NOC	ENG
DBY-UJ	local-authority-eng:NOE	ENG
HRT-UF	local-authority-eng:NOH	ENG
LIN-UE	local-authority-eng:NOK	ENG
NFK-UF	local-authority-eng:NON	ENG
NSM	local-authority-eng:NSM	ENG
NTT-UG	local-authority-eng:NSW	ENG
NTH	local-authority-eng:NTH	ENG
NTT	local-authority-eng:NTT	ENG
NTY	local-authority-eng:NTY	ENG
WAR-UC	local-authority-eng:NUA	ENG
WAR-UB	local-authority-eng:NWK	ENG
LEC-UH	local-authority-eng:NWL	ENG
NWM	local-authority-eng:NWM	ENG
NYK	local-authority-eng:NYK	ENG
LEC-UJ	local-authority-eng:OAA	ENG
OLD	local-authority-eng:OLD	ENG
OXF-UC	local-authority-eng:OXC	ENG
OXF	local-authority-eng:OXF	ENG
LAN-UJ	local-authority-eng:PEB	ENG
PLY	local-authority-eng:PLY	ENG
POL	local-authority-eng:POL	ENG
POR	local-authority-eng:POR	ENG
LAN-UK	local-authority-eng:PRC	ENG
PTE	local-authority-eng:PTE	ENG
DOR-UG	local-authority-eng:PUD	ENG
RCC	local-authority-eng:RCC	ENG
ESS-UL	local-authority-eng:RCF	ENG
NTT-UJ	local-authority-eng:RUC	ENG
RCH	local-authority-eng:RCH	ENG
RDB	local-authority-eng:RDB	ENG
RDG	local-authority-eng:RDG	ENG
SRY-UF	local-authority-eng:REA	ENG
WOR-UD	local-authority-eng:REB	ENG
WAR-UD	local-authority-eng:RGB	ENG
RIC	local-authority-eng:RIC	ENG
NYK-UE	local-authority-eng:RID	ENG
LAN-UL	local-authority-eng:RIV	ENG
LAN-UM	local-authority-eng:ROB	ENG
ROT	local-authority-eng:ROT	ENG
HAM-UL	local-authority-eng:RSM	ENG
ESX-UG	local-authority-eng:RTR	ENG
RUT	local-authority-eng:RUT	ENG
NYK-UF	local-authority-eng:RYD	ENG
SRY-UG	local-authority-eng:RYM	ENG
HRT-UG	local-authority-eng:SAC	ENG
SAW	local-authority-eng:SAW	ENG
NYK-UH	local-authority-eng:SBY	ENG
NYK-UG	local-authority-eng:SCB	ENG
SFK-UF	local-authority-eng:SDM	ENG
SFK	local-authority-eng:SFK	ENG
SFT	local-authority-eng:SFT	ENG
SGC	local-authority-eng:SGC	ENG
SOM-UC	local-authority-eng:SGM	ENG
DEV-UG	local-authority-eng:SHA	ENG
KEN-UL	local-authority-eng:SHD	ENG
SHF	local-authority-eng:SHF	ENG
SOL	local-authority-eng:SHL	ENG
SHN	local-authority-eng:SHN	ENG
LIN-UF	local-authority-eng:SHO	ENG
SHR	local-authority-eng:SHR	ENG
SKP	local-authority-eng:SKP	ENG
CMA-UG	local-authority-eng:SLA	ENG
SLF	local-authority-eng:SLF	ENG
SLG	local-authority-eng:SLG	ENG
SND	local-authority-eng:SND	ENG
NTH-UG	local-authority-eng:SNH	ENG
NFK-UH	local-authority-eng:SNK	ENG
WAR-UE	local-authority-eng:SOA	ENG
BKM-UE	local-authority-eng:SOB	ENG
CAM-UG	local-authority-eng:SOC	ENG
DBY-UK	local-authority-eng:SOD	ENG
LIN-UG	local-authority-eng:SOK	ENG
SOM	local-authority-eng:SOM	ENG
LAN-UN	local-authority-eng:SOR	ENG
STE	local-authority-eng:SOT	ENG
OXF-UD	local-authority-eng:SOX	ENG
SRY-UH	local-authority-eng:SPB	ENG
GLS-UF	local-authority-eng:SRD	ENG
SRY	local-authority-eng:SRY	ENG
SOS	local-authority-eng:SSE	ENG
SOM-UD	local-authority-eng:SSM	ENG
STS-UF	local-authority-eng:SST	ENG
STS-UG	local-authority-eng:STA	ENG
STH	local-authority-eng:STH	ENG
STS-UH	local-authority-eng:STM	ENG
STN	local-authority-eng:STN	ENG
STS	local-authority-eng:STS	ENG
STT	local-authority-eng:STT	ENG
HRT-UH	local-authority-eng:STV	ENG
STY	local-authority-eng:STY	ENG
SFK-UG	local-authority-eng:SUC	ENG
SRY-UJ	local-authority-eng:SUH	ENG
KEN-UK	local-authority-eng:SVK	ENG
KEN-UM	local-authority-eng:SWB	ENG
SWD	local-authority-eng:SWD	ENG
SWK	local-authority-eng:SWK	ENG
STS-UK	local-authority-eng:TAB	ENG
TAM	local-authority-eng:TAM	ENG
DEV-UH	local-authority-eng:TBG	ENG
SOM-UE	local-authority-eng:TDE	ENG
SRY-UK	local-authority-eng:TDG	ENG
ESS-UN	local-authority-eng:TDR	ENG
GLS-UG	local-authority-eng:TEB	ENG
HAM-UN	local-authority-eng:TEV	ENG
TFW	local-authority-eng:TFW	ENG
KEN-UN	local-authority-eng:THD	ENG
KEN-UP	local-authority-eng:TOA	ENG
TOB	local-authority-eng:TOB	ENG
DEV-UK	local-authority-eng:TOD	ENG
TRF	local-authority-eng:TRF	ENG
HRT-UJ	local-authority-eng:TRR	ENG
THR	local-authority-eng:TUK	ENG
KEN-UQ	local-authority-eng:TUW	ENG
TWH	local-authority-eng:TWH	ENG
ESS-UQ	local-authority-eng:UTD	ENG
OXF-UE	local-authority-eng:VAO	ENG
WBK	local-authority-eng:WBK	ENG
DEV-UL	local-authority-eng:WDE	ENG
DOR-UH	local-authority-eng:WDO	ENG
NTH-UH	local-authority-eng:WEB	ENG
HRT-UL	local-authority-eng:WEH	ENG
OXF-UF	local-authority-eng:WEO	ENG
SOM-UF	local-authority-eng:WES	ENG
WFT	local-authority-eng:WFT	ENG
WGN	local-authority-eng:WGN	ENG
HAM-UP	local-authority-eng:WIC	ENG
WIL	local-authority-eng:WIL	ENG
WKF	local-authority-eng:WKF	ENG
SRY-UM	local-authority-eng:WKG	ENG
WAR	local-authority-eng:WKS	ENG
LAN-UP	local-authority-eng:WLA	ENG
ESX-UH	local-authority-eng:WLD	ENG
LIN-UH	local-authority-eng:WLI	ENG
WLL	local-authority-eng:WLL	ENG
WLV	local-authority-eng:WLV	ENG
WND	local-authority-eng:WND	ENG
WNM	local-authority-eng:WNM	ENG
SFK-UH	local-authority-eng:WNY	ENG
WSX-UH	local-authority-eng:WOB	ENG
WOR-UE	local-authority-eng:WOC	ENG
WOK	local-authority-eng:WOK	ENG
WOR	local-authority-eng:WOR	ENG
DOR-UJ	local-authority-eng:WPO	ENG
WRL	local-authority-eng:WRL	ENG
WRT	local-authority-eng:WRT	ENG
WSM	local-authority-eng:WSM	ENG
WSX	local-authority-eng:WSX	ENG
HRT-UK	local-authority-eng:WTF	ENG
SRY-UL	local-authority-eng:WVY	ENG
WAR-UF	local-authority-eng:WWK	ENG
LAN-UQ	local-authority-eng:WYC	ENG
BKM-UF	local-authority-eng:WYD	ENG
WOR-UG	local-authority-eng:WYF	ENG
WOR-UF	local-authority-eng:WYN	ENG
YOR	local-authority-eng:YOR	ENG
ABD	local-authority-sct:ABD	SCT
ABE	local-authority-sct:ABE	SCT
AGB	local-authority-sct:AGB	SCT
ANS	local-authority-sct:ANS	SCT
CLK	local-authority-sct:CLK	SCT
DGY	local-authority-sct:DGY	SCT
DND	local-authority-sct:DND	SCT
EAY	local-authority-sct:EAY	SCT
EDH	local-authority-sct:EDH	SCT
EDU	local-authority-sct:EDU	SCT
ELN	local-authority-sct:ELN	SCT
ELS	local-authority-sct:ELS	SCT
ERW	local-authority-sct:ERW	SCT
FAL	local-authority-sct:FAL	SCT
FIF	local-authority-sct:FIF	SCT
GLG	local-authority-sct:GLG	SCT
HLD	local-authority-sct:HLD	SCT
IVC	local-authority-sct:IVC	SCT
MLN	local-authority-sct:MLN	SCT
MRY	local-authority-sct:MRY	SCT
NAY	local-authority-sct:NAY	SCT
NLK	local-authority-sct:NLK	SCT
ORK	local-authority-sct:ORK	SCT
PKN	local-authority-sct:PKN	SCT
RFW	local-authority-sct:RFW	SCT
SAY	local-authority-sct:SAY	SCT
SCB	local-authority-sct:SCB	SCT
SLK	local-authority-sct:SLK	SCT
STG	local-authority-sct:STG	SCT
WDU	local-authority-sct:WDU	SCT
WLN	local-authority-sct:WLN	SCT
ZET	local-authority-sct:ZET	SCT
ABC	local-authority-nir:ABC	NIR
AND	local-authority-nir:AND	NIR
ANN	local-authority-nir:ANN	NIR
BFS	local-authority-nir:BFS	NIR
CCG	local-authority-nir:CCG	NIR
DRS	local-authority-nir:DRS	NIR
FMO	local-authority-nir:FMO	NIR
LBC	local-authority-nir:LBC	NIR
MEA	local-authority-nir:MEA	NIR
MUL	local-authority-nir:MUL	NIR
NMD	local-authority-nir:NMD	NIR
NIR-A	local-authority-nir:NIR-A	NIR
NIR-B	local-authority-nir:NIR-B	NIR
NIR-C	local-authority-nir:NIR-C	NIR
NIR-D	local-authority-nir:NIR-D	NIR
NIR-E	local-authority-nir:NIR-E	NIR
NIR-F	local-authority-nir:NIR-F	NIR
NIR-G	local-authority-nir:NIR-G	NIR
NIR-H	local-authority-nir:NIR-H	NIR
NIR-I	local-authority-nir:NIR-I	NIR
NIR-J	local-authority-nir:NIR-J	NIR
NIR-K	local-authority-nir:NIR-K	NIR
NIR-L	local-authority-nir:NIR-L	NIR
NIR-M	local-authority-nir:NIR-M	NIR
NIR-N	local-authority-nir:NIR-N	NIR
NIR-O	local-authority-nir:NIR-O	NIR
NIR-P	local-authority-nir:NIR-P	NIR
NIR-Q	local-authority-nir:NIR-Q	NIR
NIR-R	local-authority-nir:NIR-R	NIR
NIR-S	local-authority-nir:NIR-S	NIR
NIR-T	local-authority-nir:NIR-T	NIR
NIR-U	local-authority-nir:NIR-U	NIR
NIR-V	local-authority-nir:NIR-V	NIR
NIR-W	local-authority-nir:NIR-W	NIR
NIR-X	local-authority-nir:NIR-X	NIR
NIR-Y	local-authority-nir:NIR-Y	NIR
AGY	local-authority-wls:AGY	WLS
BGE	local-authority-wls:BGE	WLS
BGW	local-authority-wls:BGW	WLS
CAY	local-authority-wls:CAY	WLS
CGN	local-authority-wls:CGN	WLS
CMN	local-authority-wls:CMN	WLS
CRF	local-authority-wls:CRF	WLS
CWY	local-authority-wls:CWY	WLS
DEN	local-authority-wls:DEN	WLS
FLN	local-authority-wls:FLN	WLS
GWN	local-authority-wls:GWN	WLS
MON	local-authority-wls:MON	WLS
MTY	local-authority-wls:MTY	WLS
NTL	local-authority-wls:NTL	WLS
NWP	local-authority-wls:NWP	WLS
PEM	local-authority-wls:PEM	WLS
POW	local-authority-wls:POW	WLS
RCT	local-authority-wls:RCT	WLS
SWA	local-authority-wls:SWA	WLS
TOF	local-authority-wls:TOF	WLS
VGL	local-authority-wls:VGL	WLS
WRX	local-authority-wls:WRX	WLS
